OOOOOOOOOOBOOOO
OBOOBBBBBBOOOOO
OBOBBOOOOOOOOOO
OBBBOOOOOOOOOOO
OOOOBOOOBBBBBOO
OBBBOOOOOOOOBOO
OBBOOOOOOOOOOOO
OBBOOOOBOBOBOBB
OOOOBOOOOOOOOOO
OBBOOOBOOOOOOOO
OBBOOBBOOOOBOOO
OBBOOOBBBBBBOOO
OBBOOOOOOOOBOOO
OOBOOOOOOOOOBOO